DFPPHHMMT
FFPPHHMMM
PPPHHHMMM
PPHHHHMMM
HHHHHHMMM
HHHHHMMMM
HHHHMMMMM
MMMMMMMMM
MMMMMMMMM
